1
2
3
4
5
6
7
8
9
10
11
12
13
14
15
14 15
13 14 15
12 13 14 15
11 12 13 14 15
10 11 12 13 14 15
9 10 11 12 13 14 15
8 9 10 11 12 13 14 15
7 8 9 10 11 12 13 14 15
6 7 8 9 10 11 12 13 14 15
5 6 7 8 9 10 11 12 13 14 15
4 5 6 7 8 9 10 11 12 13 14 15
3 4 5 6 7 8 9 10 11 12 13 14 15
2 3 4 5 6 7 8 9 10 11 12 13 14 15
1 2 3 4 5 6 7 8 9 10 11 12 13 14 15